R 1080 768
NO ./textures/redbrick.xpm
SO ./textures/mossy.xpm
WE ./textures/stone.xpm
EA ./textures/wood.xpm

S ./textures/sprites/chest.xpm
X ./textures/sprites/skeleton.xpm
F 220,100,0
C 225,30,0

11111111111111111
10001000100010001
10000000000000001
10000000000000001
10000000100000001
11000001110000011
10000011111000001
10000001110000001
10000011111000001
11000001110000011
10000000100000001
10000000000000001
10000000S00000001
10001000000010001
11111111111111111
