R 1080 768
NO ./textures/redbrick.xpm
SO ./textures/mossy.xpm
WE ./textures/stone.xpm
EA ./textures/wood.xpm

S ./textures/sprites/chest.xpm
X ./textures/sprites/skeleton.xpm
F 220,100,0
C 225,30,0

11111111111111111111111111111111
10000110000010000100000010000111
10110000111011010110111010110111
10011011101110000000101010110001
11011011001111110110001000010101
11010001100001000011101111010001
10010101001011011000100100011011
10111101101000N01110110101000011
10101000000011011100100101101111
10101110110110000101110111000001
10001000011100110101000001110111
10100011000101100001101100000011
10111010011101101100101110111001
11100011010000001110001000110001
11111111111111111111111111111111
