R 1080 768
NO ./textures/redbrick.xpm
SO ./textures/mossy.xpm
WE ./textures/stone.xpm
EA ./textures/wood.xpm

S ./textures/sprites/chest.xpm
X ./textures/sprites/skeleton.xpm
F 220,100,0
C 225,30,0

111111111111111111
101100000010000001
100001011000101101
110111001101100101
100001100100101111
101101101110100001
100101100010111101
110100111010001101
110110100N11100001
110010001110001011
111010100010111011
100010111011100001
101110001000111111
100011011110000001
111111111111111111
